4,0,0,0,0,0,0,0,0,0,0,0,0,0,0,0,0,4
4,0,0,0,0,0,0,0,0,0,0,0,0,0,0,0,0,4
4,0,0,0,0,0,a,0,0,0,0,a,0,0,0,0,0,4
4,0,0,0,0,1,3,3,3,3,3,3,2,0,0,0,0,4
4,0,0,1,2,0,0,0,0,0,0,0,0,1,2,0,0,4
4,0,0,e,0,0,0,0,0,0,0,0,0,0,e,0,0,4
4,3,3,3,3,3,3,2,0,0,1,3,3,3,3,3,3,4
4,0,0,0,0,0,e,0,0,0,0,e,0,0,0,0,0,4
4,0,0,0,1,3,3,3,3,3,3,3,3,2,0,0,0,4
4,0,0,a,0,0,0,0,0,0,0,0,0,0,a,0,0,4
4,3,3,3,2,0,0,1,3,3,2,0,0,1,3,3,3,4
4,0,0,0,0,0,0,0,0,0,0,0,0,0,0,0,0,4
3,3,3,3,3,3,3,3,3,3,3,3,3,3,3,3,3,3

