4,0,0,0,0,0,0,0,0,0,0,0,0,0,0,0,0,4
4,0,0,0,0,0,0,0,0,0,0,0,0,0,0,0,0,4
4,0,0,e,0,0,0,0,0,0,0,0,0,0,e,0,0,4
4,3,3,3,3,2,0,0,1,2,0,0,1,3,3,3,3,4
4,0,0,a,0,0,0,0,0,0,0,0,0,0,a,0,0,4
4,3,3,2,0,0,0,1,3,3,2,0,0,0,1,3,3,4
4,0,0,0,0,0,0,0,0,0,0,0,0,0,0,0,0,4
4,3,2,0,0,0,0,a,0,0,a,0,0,0,0,1,3,4
4,0,0,0,0,1,3,3,3,3,3,3,2,0,0,0,0,4
4,2,0,0,e,0,0,0,0,0,0,0,0,e,0,0,1,4
4,0,0,0,5,6,0,0,1,2,0,0,5,6,0,0,0,4
4,0,0,0,7,8,0,0,0,0,0,0,7,8,0,0,0,4
3,3,3,3,9,u,3,3,3,3,3,3,9,u,3,3,3,3